NO ./path_to_the_north_texture
SO ./path_to_the_south_texture
WE ./path_to_the_west_texture
EA ./path_to_the_east_texture

F 220,100,0
C 225,30,10

1111111111
1000000001
1000001001
1111000001
1000000001
1000000011
1111000011
1000000001
1100000011
1111111111