NO ./assets/texture1.xpm
EA ./assets/texture2.xpm
SO ./assets/texture3.xpm
WE ./assets/texture4.xpm

C 127,127, 127
F 0,0,127

1111111111111111111111111111111
1000000000000000000000000000001
1000001000000000000000000000001
1111000000000000000000000000001
1000000000000000000000000000001
1000000000000000000E00000000011
1111000000000000000000000000011
1000000000000000000000000000001
1100000000000000000000000000011
11111111111111111111111111111111
