NO ./path_to_the_north_texture
EA ./path_to_the_east_texture
SO ./path_to_the_south_texture
WE ./path_to_the_west_texture

C 127,127,127
F 254,0,0

111111111
1000S0111
1111111